0101 0001 0001 0001 0001 0001 1001 0101 1001 0101 0001 1011 0111 1011 0111 0001 0011 0011 0011 0001 0011 0011 1001
0100 0000 0000 0000 0000 0000 1000 0110 1010 1100 0110 0011 0011 0011 0011 0010 1001 0101 0011 1000 0101 0001 1000 
0100 0010 0010 0010 0010 0010 0010 0011 0011 0010 0011 0011 0011 0011 0011 0011 0010 1010 1111 0110 0010 1000 1100
1100 1101 1101 0101 0011 0011 0001 0001 1001 0101 1001 0101 1001 0101 0011 1001 0101 0011 0001 0001 1001 1100 1110
1100 1100 1100 1100 0101 1001 0100 0000 1000 1100 1100 1100 1100 0110 1001 1100 0100 1011 0100 1010 1100 0110 1001
0110 0010 1000 1100 1100 1100 0110 0010 1000 1100 1100 1100 0110 0011 1010 1100 1100 0101 1010 0101 1000 1101 1100
0101 1001 1100 1100 1100 0110 0011 1001 1100 1100 1100 0110 0011 1001 0101 1010 0100 1010 0101 1010 1100 1100 1110 
0100 1000 1100 1100 0110 0001 1011 1100 1110 1100 0110 0001 1011 1100 0110 0001 0010 0011 1000 0101 1010 1100 1100
0100 0010 1010 0100 1001 0100 1011 0110 0011 0000 1011 0110 0011 0010 1001 1100 0101 1011 0110 1010 1101 1100 1100 
1100 0101 1001 1100 1100 0110 0011 0001 1011 1100 0111 0001 0011 1001 1100 0100 0010 0011 0011 0011 1000 1100 1100
1100 0110 1010 1100 0110 0011 1001 0110 0011 0000 0011 1010 0101 1010 1100 0110 1011 0001 0011 1001 1110 0100 1010 
0110 0011 1011 1100 0101 1001 0110 0011 1011 1100 0111 1001 0000 1001 0110 0011 0011 1010 1101 0110 1001 1100 1101 
1101 0101 1001 1100 1100 0110 0011 0011 0011 0000 0011 1000 1100 0010 0011 0011 0011 0011 1000 1101 1100 1100 1100 
1100 0010 1010 1100 0110 0011 0011 1001 1101 1100 1101 1100 0110 0011 0011 0011 0011 0011 0011 0010 1100 1100 1010
0110 0011 1011 0100 1001 0101 0011 1010 1100 1100 1100 0110 0011 0011 0011 0011 0001 0011 0011 1011 1100 0101 1001
1111 0000 1111 1100 1100 0110 0011 0011 1010 1100 0110 0011 0011 1001 0101 1001 1100 0101 0011 0011 1010 1100 1100 
0100 0010 1001 1100 1110 0101 1001 0101 0011 0010 0001 0011 0011 1000 1100 1100 1100 0110 0011 0011 1001 1110 1100
0100 1011 1100 0110 1001 0100 1000 0110 0011 1001 0100 0011 1001 1110 1100 1100 0100 0011 0011 1011 1100 0111 1010
1100 0111 1000 1101 1100 0110 0010 0011 0011 1010 1100 1100 1100 0101 1010 0110 1010 0101 0011 0011 1001 0101 1001
0110 1001 1100 1100 0110 0011 0011 0011 0011 0011 1000 1100 1100 0000 0000 0101 1100 0101 0011 0011 1010 1110 1100
0101 1010 1110 0100 0011 0011 1001 0101 1001 0101 1010 1100 1100 0100 1000 1100 1100 0101 0111 0011 1010 1110 1100 
0110 0011 1001 0100 0011 1011 1100 0110 0010 0010 0011 1010 1100 0000 1000 1010 0100 0011 0011 1011 0101 0101 1010 
0101 0011 1010 0110 0011 0011 0010 0011 0011 0011 0011 0011 1010 0110 1010 0110 0110 0010 0011 0011 1011 1100 1101
0110 0011 1001 0101 0011 1001 0101 0001 0011 0011 0011 0011 0011 1011 0101 0011 1011 1100 0110 0001 0011 1000 1110 
0101 0001 1010 1100 0111 1010 1100 0110 0011 0011 0011 0011 0011 0011 0000 0011 0011 0010 0011 0110 1011 0000 1000
0110 0010 0011 0010 0011 0011 0010 0011 0011 0011 0011 0011 0011 0011 0010 0011 0011 0011 0011 0011 0011 0010 1010 





