0101 0001 0001 0001 0001 0001 0001 0001 0001 0001 0001 0001 0001 0001 1001
0100 0000 0000 0000 0000 0000 0000 0000 0000 0000 0000 0000 0000 0000 1000
0100 0000 0000 0000 0000 0000 0000 0000 0000 0000 0000 0000 0000 0000 1000
0100 0000 0000 0000 0000 0000 0000 0000 0000 0000 0000 0000 0000 0000 1000
0100 0000 0000 0000 0000 0000 0000 0000 0000 0000 0000 0000 0000 0000 1000
0100 0000 0000 0000 0000 0000 0000 0000 0000 0000 0000 0000 0000 0000 1000
0100 0000 0000 0000 0000 0000 0000 0000 0000 0000 0000 0000 0000 0000 1000
0100 0000 0000 0000 0000 0000 0000 0000 0000 0000 0000 0000 0000 0000 1000
0100 0000 0000 0000 0000 0000 0000 0000 0000 0000 0000 0000 0000 0000 1000
0100 0000 0000 0000 0000 0000 0000 0000 0000 0000 0000 0000 0000 0000 1000
0100 0000 0000 0000 0000 0000 0000 0000 0000 0000 0000 0000 0000 0000 1000
0100 0000 0000 0000 0000 0000 0000 0000 0000 0000 0000 0000 0000 0000 1000
0110 0010 0010 0010 0010 0010 0010 0010 0010 0010 0010 0010 0010 0010 1010 